50,8,,,,,,
0,0,0,1,0,0,0,0
0,0,0,0,13,0,0,0
0,0,0,0,0,0,0,0
0,0,0,4,0,0,0,0
0,1,0,0,0,0,0,0
0,0,1,6,1,0,0,0
0,1,1,1,0,13,0,0
0,0,1,1,0,1,0,0
0,1,13,1,1,1,1,0
0,0,0,0,0,0,0,0
0,1,0,0,0,0,5,0
0,0,0,0,1,0,0,0
0,0,0,0,0,0,0,0
0,0,6,1,1,13,0,0
1,13,1,1,13,1,1,1
1,1,1,13,1,1,1,1
13,13,1,1,1,1,0,0
0,0,1,1,0,13,0,0
0,0,0,0,0,0,0,0
0,1,1,0,23,0,0,0
0,0,0,0,0,0,0,0
0,0,0,1,0,0,0,0
0,0,0,0,0,0,0,0
0,0,0,0,0,0,0,0
0,13,0,0,0,0,0,0
0,0,1,1,6,1,1,0
1,1,13,1,1,1,13,1
1,1,1,1,23,1,1,1
1,1,1,1,1,1,1,1
0,0,0,0,0,0,0,0
0,0,1,4,0,0,0,0
0,1,0,0,0,0,0,0
0,0,0,1,0,0,0,0
0,0,0,0,13,0,0,0
0,0,0,1,0,0,0,0
0,0,0,0,0,0,0,0
0,1,1,1,6,1,13,13
13,13,13,13,1,1,13,13
1,13,23,13,1,13,1,13
1,1,1,1,1,1,1,1
0,0,0,0,0,0,0,0
0,0,0,1,0,0,0,0
0,0,0,0,1,0,0,0
0,1,0,1,0,23,0,0
0,0,0,0,0,0,0,0
0,0,0,0,0,13,0,0
0,1,6,23,0,0,0,0
1,23,23,1,13,23,1,13
1,23,1,23,23,23,23,0
0,0,0,0,0,0,1,0